85 39
DB9000 DB9000 DB9000 DB9000 DB9000 DB9000 DB9000 DB9000 DB9000 DB9000 DB9000 DB9000 DB9000 DB9000 DB9000 DB9000 DB9000 DB9000 DB9000 DB9000 DB9000 DB9000 DB9000 DB9000 DB9000 DB9000 DB9000 DB9000 DB9000 DB9000 DB9000 DB9000 DB9000 B17900 B17900 B17900 DB9000 DB9000 DB9000 DB9000 DB9000 DB9000 DB9000 DB9000 DB9000 DB9000 DB9000 DB9000 DB9000 DB9000 DB9000 DB9000 DB9000 DB9000 DB9000 DB9000 DB9000 DB9000 DB9000 DB9000 DB9000 DB9000 DB9000 DB9000 DB9000 DB9000 DB9000 DB9000 DB9000 DB9000 DB9000 DB9000 DB9000 DB9000 DB9000 DB9000 DB9000 DB9000 DB9000 DB9000 DB9000 DB9000 DB9000 B17900 B17900 
DB9000 DB9000 DB9000 DB9000 DB9000 DB9000 DB9000 DB9000 DB9000 DB9000 DB9000 DB9000 DB9000 DB9000 DB9000 DB9000 DB9000 DB9000 DB9000 DB9000 DB9000 DB9000 DB9000 DB9000 DB9000 DB9000 DB9000 DB9000 DB9000 DB9000 DB9000 DB9000 B17900 B17900 B17900 B17900 B17900 B17900 DB9000 DB9000 DB9000 DB9000 DB9000 DB9000 DB9000 DB9000 DB9000 DB9000 DB9000 DB9000 DB9000 DB9000 DB9000 DB9000 DB9000 DB9000 DB9000 DB9000 DB9000 DB9000 DB9000 DB9000 DB9000 DB9000 DB9000 DB9000 DB9000 DB9000 DB9000 DB9000 DB9000 DB9000 DB9000 DB9000 DB9000 DB9000 DB9000 DB9000 DB9000 DB9000 B17900 B17900 B17900 B17900 B17900 
DB9000 DB9000 DB9000 DB9000 DB9000 DB9000 DB9000 DB9000 DB9000 DB9000 DB9000 DB9000 DB9000 DB9000 DB9000 DB9000 DB9000 DB9000 DB9000 DB9000 DB9000 DB9000 DB9000 DB9000 DB9000 DB9000 DB9000 DB9000 DB9000 DB9000 DB9000 DB9000 DB9000 DB9000 DB9000 DB9000 DB9000 DB9000 DB9000 DB9000 DB9000 DB9000 DB9000 DB9000 DB9000 DB9000 DB9000 DB9000 DB9000 DB9000 DB9000 DB9000 DB9000 DB9000 DB9000 DB9000 DB9000 DB9000 DB9000 DB9000 DB9000 DB9000 DB9000 DB9000 DB9000 DB9000 DB9000 DB9000 DB9000 DB9000 DB9000 DB9000 DB9000 DB9000 DB9000 DB9000 DB9000 DB9000 DB9000 DB9000 DB9000 DB9000 DB9000 DB9000 DB9000 
DB9000 DB9000 DB9000 DB9000 DB9000 DB9000 DB9000 DB9000 DB9000 DB9000 DB9000 DB9000 DB9000 DB9000 DB9000 DB9000 DB9000 DB9000 DB9000 DB9000 DB9000 DB9000 DB9000 DB9000 DB9000 DB9000 DB9000 DB9000 DB9000 DB9000 DB9000 DB9000 DB9000 DB9000 DB9000 DB9000 DB9000 DB9000 DB9000 DB9000 DB9000 DB9000 DB9000 DB9000 DB9000 DB9000 DB9000 DB9000 DB9000 DB9000 B17900 B17900 B17900 DB9000 DB9000 DB9000 DB9000 DB9000 DB9000 DB9000 DB9000 DB9000 DB9000 DB9000 DB9000 DB9000 DB9000 DB9000 DB9000 DB9000 DB9000 DB9000 DB9000 DB9000 DB9000 DB9000 DB9000 DB9000 DB9000 DB9000 DB9000 DB9000 DB9000 DB9000 DB9000 
DB9000 DB9000 DB9000 DB9000 B17900 B17900 B17900 B17900 B17900 DB9000 DB9000 DB9000 DB9000 DB9000 DB9000 DB9000 DB9000 DB9000 DB9000 DB9000 DB9000 DB9000 DB9000 DB9000 DB9000 DB9000 DB9000 DB9000 DB9000 DB9000 DB9000 DB9000 DB9000 DB9000 DB9000 DB9000 DB9000 DB9000 DB9000 DB9000 DB9000 DB9000 DB9000 DB9000 DB9000 DB9000 DB9000 DB9000 B17900 B17900 B17900 B17900 B17900 B17900 B17900 B17900 DB9000 DB9000 DB9000 DB9000 DB9000 DB9000 DB9000 DB9000 DB9000 DB9000 DB9000 DB9000 DB9000 DB9000 DB9000 DB9000 DB9000 DB9000 DB9000 DB9000 DB9000 DB9000 DB9000 DB9000 DB9000 DB9000 DB9000 DB9000 DB9000 
DB9000 B17900 B17900 B17900 B17900 B17900 B17900 B17900 B17900 B17900 B17900 B17900 B17900 B17900 DB9000 DB9000 DB9000 DB9000 DB9000 DB9000 DB9000 DB9000 DB9000 DB9000 DB9000 DB9000 DB9000 DB9000 DB9000 DB9000 DB9000 DB9000 DB9000 DB9000 DB9000 DB9000 DB9000 DB9000 DB9000 DB9000 DB9000 DB9000 DB9000 DB9000 DB9000 DB9000 DB9000 B17900 B17900 B17900 B17900 B17900 B17900 B17900 B17900 DB9000 DB9000 DB9000 DB9000 DB9000 DB9000 DB9000 DB9000 DB9000 DB9000 DB9000 DB9000 DB9000 DB9000 DB9000 DB9000 DB9000 B17900 B17900 B17900 B17900 B17900 DB9000 DB9000 DB9000 DB9000 DB9000 DB9000 DB9000 DB9000 
DB9000 B17900 B17900 B17900 B17900 B17900 B17900 B17900 B17900 B17900 B17900 B17900 B17900 B17900 DB9000 DB9000 DB9000 DB9000 DB9000 DB9000 DB9000 DB9000 DB9000 DB9000 DB9000 DB9000 DB9000 DB9000 DB9000 DB9000 DB9000 DB9000 DB9000 DB9000 DB9000 DB9000 DB9000 DB9000 DB9000 DB9000 DB9000 DB9000 DB9000 DB9000 DB9000 DB9000 B17900 DB9000 DB9000 B17900 B17900 DB9000 DB9000 DB9000 DB9000 DB9000 DB9000 DB9000 DB9000 DB9000 DB9000 DB9000 DB9000 DB9000 DB9000 DB9000 DB9000 DB9000 DB9000 DB9000 DB9000 B17900 B17900 B17900 B17900 DB9000 B17900 DB9000 DB9000 DB9000 DB9000 DB9000 DB9000 DB9000 DB9000 
DB9000 B17900 DB9000 DB9000 DB9000 DB9000 B17900 B17900 B17900 B17900 DB9000 DB9000 DB9000 DB9000 DB9000 DB9000 DB9000 DB9000 DB9000 DB9000 DB9000 DB9000 DB9000 DB9000 DB9000 DB9000 DB9000 DB9000 DB9000 DB9000 DB9000 DB9000 DB9000 DB9000 DB9000 DB9000 DB9000 DB9000 DB9000 DB9000 DB9000 DB9000 DB9000 DB9000 DB9000 DB9000 DB9000 DB9000 DB9000 DB9000 DB9000 DB9000 DB9000 DB9000 DB9000 DB9000 DB9000 DB9000 DB9000 DB9000 DB9000 DB9000 DB9000 DB9000 DB9000 DB9000 DB9000 DB9000 DB9000 DB9000 DB9000 DB9000 DB9000 DB9000 DB9000 DB9000 DB9000 DB9000 DB9000 DB9000 DB9000 DB9000 DB9000 DB9000 DB9000 
DB9000 DB9000 DB9000 DB9000 DB9000 DB9000 DB9000 DB9000 DB9000 DB9000 DB9000 DB9000 DB9000 DB9000 DB9000 DB9000 DB9000 DB9000 DB9000 DB9000 DB9000 DB9000 DB9000 B17900 B17900 DB9000 DB9000 DB9000 DB9000 DB9000 DB9000 DB9000 DB9000 DB9000 DB9000 DB9000 DB9000 DB9000 DB9000 DB9000 DB9000 DB9000 DB9000 DB9000 DB9000 DB9000 DB9000 DB9000 DB9000 DB9000 DB9000 DB9000 DB9000 DB9000 DB9000 DB9000 DB9000 DB9000 DB9000 DB9000 DB9000 DB9000 DB9000 DB9000 DB9000 DB9000 DB9000 DB9000 DB9000 DB9000 DB9000 DB9000 DB9000 DB9000 DB9000 DB9000 DB9000 DB9000 DB9000 DB9000 DB9000 DB9000 DB9000 DB9000 DB9000 
DB9000 DB9000 DB9000 DB9000 DB9000 DB9000 DB9000 DB9000 DB9000 DB9000 DB9000 DB9000 DB9000 DB9000 DB9000 B17900 B17900 B17900 B17900 B17900 DB9000 B17900 B17900 B17900 B17900 B17900 B17900 B17900 B17900 B17900 DB9000 DB9000 DB9000 DB9000 DB9000 DB9000 DB9000 DB9000 DB9000 DB9000 DB9000 DB9000 DB9000 DB9000 DB9000 DB9000 DB9000 DB9000 DB9000 DB9000 DB9000 DB9000 DB9000 DB9000 DB9000 DB9000 DB9000 DB9000 DB9000 DB9000 DB9000 DB9000 DB9000 DB9000 DB9000 DB9000 DB9000 DB9000 DB9000 DB9000 DB9000 DB9000 DB9000 DB9000 DB9000 DB9000 DB9000 DB9000 DB9000 DB9000 DB9000 DB9000 DB9000 DB9000 DB9000 
DB9000 DB9000 DB9000 DB9000 DB9000 DB9000 DB9000 DB9000 DB9000 DB9000 DB9000 DB9000 DB9000 DB9000 DB9000 DB9000 B17900 B17900 B17900 B17900 B17900 B17900 B17900 B17900 B17900 B17900 B17900 B17900 B17900 B17900 B17900 DB9000 DB9000 DB9000 DB9000 DB9000 DB9000 DB9000 DB9000 DB9000 DB9000 DB9000 DB9000 DB9000 DB9000 DB9000 DB9000 DB9000 DB9000 DB9000 DB9000 DB9000 DB9000 DB9000 DB9000 DB9000 DB9000 DB9000 DB9000 DB9000 DB9000 DB9000 DB9000 DB9000 DB9000 DB9000 DB9000 DB9000 DB9000 DB9000 DB9000 DB9000 DB9000 DB9000 DB9000 DB9000 DB9000 DB9000 DB9000 DB9000 DB9000 DB9000 DB9000 DB9000 DB9000 
DB9000 DB9000 DB9000 DB9000 DB9000 DB9000 DB9000 DB9000 DB9000 DB9000 DB9000 DB9000 DB9000 DB9000 DB9000 DB9000 DB9000 DB9000 DB9000 DB9000 DB9000 DB9000 DB9000 DB9000 DB9000 DB9000 DB9000 DB9000 DB9000 DB9000 DB9000 DB9000 DB9000 DB9000 DB6000 DB6000 DB6000 DB6000 DB6000 DB6000 DB6000 DB6000 DB6000 DB9000 DB9000 DB9000 DB9000 DB9000 DB9000 DB9000 B09900 DB9000 DB9000 DB9000 DB9000 DB9000 DB9000 DB9000 DB9000 DB9000 DB9000 DB9000 DB9000 DB9000 DB9000 DB9000 DB9000 B17900 B17900 B02900 B17900 B17900 DB9000 DB9000 DB9000 DB9000 DB9000 DB9000 DB9000 DB9000 DB9000 DB9000 DB9000 DB9000 DB9000 
DB9000 DB9000 DB9000 DB9000 DB9000 DB9000 DB9000 DB9000 DB9000 DB9000 DB9000 DB9000 DB9000 DB9000 DB9000 DB9000 DB9000 DB9000 DB9000 DB9000 DB9000 DB9000 DB9000 DB9000 DB9000 DB9000 DB9000 DB9000 DB9000 DB9000 DB9000 DB9000 DB9000 DB6000 B26E00 B26E00 B26E00 B26E00 B26E00 B26E00 B26E00 B26E00 B26E00 DB6000 DB9000 DB9000 DB9000 DB9000 B09900 B09900 DB9000 DB9000 DB9000 DB9000 DB9000 DB9000 DB9000 DB9000 DB9000 DB9000 DB9000 DB9000 DB9000 B17900 B17900 B17900 B17900 B17900 B02900 B02900 B17900 B17900 B17900 B17900 DB9000 DB9000 DB9000 DB9000 DB9000 DB9000 DB9000 DB9000 DB9000 DB9000 DB9000 
DB9000 DB9000 DB9000 DB9000 DB9000 DB9000 DB9000 DB9000 DB9000 DB9000 DB9000 DB9000 DB9000 DB9000 DB9000 DB9000 DB9000 DB9000 DB9000 DB9000 DB9000 DB9000 DB9000 DB9000 DB9000 DB9000 DB9000 DB9000 DB9000 DB9000 DB9000 DB9000 DB6000 B26E00 B26E00 B26E00 B26E00 B26E00 B26E00 B26E00 B26E00 B26E00 B26E00 B26E00 DB6000 DB9000 DB9000 DB9000 B09900 B09900 B02900 B02900 B02900 B02900 DB9000 DB9000 DB9000 DB9000 DB9000 DB9000 DB9000 B17900 B17900 B17900 B17900 B17900 B17900 B17900 B02900 B02900 B02900 B02900 B17900 B17900 B17900 B17900 DB9000 DB9000 DB9000 DB9000 DB9000 DB9000 DB9000 DB9000 DB9000 
DB9000 DB9000 DB9000 DB9000 DB9000 DB9000 DB9000 DB9000 DB9000 DB9000 DB9000 DB9000 DB9000 DB9000 DB9000 DB9000 DB9000 DB9000 DB9000 DB9000 DB9000 DB9000 DB9000 DB9000 DB9000 DB9000 DB9000 DB9000 DB9000 DB9000 DB9000 DB6000 B26E00 B26E00 B26E00 B26E00 B26E00 B26E00 B26E00 B26E00 B26E00 B26E00 B26E00 B26E00 B26E00 DB6E00 DB9000 B09900 B09900 DB9000 B02900 B02900 B02900 B02900 DB9000 DB9000 DB9000 DB9000 DB9000 DB9000 DB9000 DB9000 DB9000 DB9000 DB9000 DB9000 DB9000 B02900 B02900 B02900 B02900 B02900 DB9000 DB9000 DB9000 DB9000 DB9000 DB9000 DB9000 DB9000 DB9000 DB9000 DB9000 DB9000 DB9000 
B17900 B17900 DB9000 DB9000 DB9000 DB9000 DB9000 DB9000 DB9000 DB9000 B02900 B02900 DB9000 DB9000 DB9000 DB9000 DB9000 DB9000 DB9000 DB9000 DB9000 DB9000 DB9000 DB9000 DB9000 DB9000 DB9000 DB9000 DB9000 DB9000 DB9000 DB6000 B26E00 B26E00 B26E00 B26E00 B26E00 B26E00 B26E00 B26E00 B26E00 B26E00 B26E00 B26E00 B26E00 DB6E00 DB9E00 DB9000 B09900 B02900 B02900 B02900 B02900 B02900 B02900 DB9000 DB9000 DB9000 DB9000 DB9000 DB9000 DB9000 DB9000 DB9000 DB9000 DB9000 DB9000 DB9000 B02900 B02900 B02900 B02900 B02900 DB9000 DB9000 DB9000 DB9000 DB9000 DB9000 DB9000 DB9000 DB9000 DB9000 DB9000 B17900 
B17900 B17900 B17900 B17900 DB9000 DB9000 DB9000 DB9000 DB9000 B02900 B02900 B02900 B02900 DB9000 DB9000 DB9000 DB9000 DB9000 DB9000 DB9000 DB9000 DB9000 DB9000 DB9000 DB9000 DB9000 DB9000 DB9000 DB9000 DB9000 DB9000 DB6000 B26E00 B26E00 B26E00 B26E00 B26E00 B26E00 B26E00 B26E00 B26E00 B26E00 B26E00 B26E00 B26E00 DB6E00 DB9E00 DB9000 DB9000 DB9000 B02900 B02900 B02900 B02900 B02900 DB9000 DB9000 DB9000 DB9000 DB9000 DB9000 DB9000 DB9000 DB9000 DB9000 DB9000 DB9000 DB9000 B02900 B02900 B02900 B02900 B02900 DB9000 DB9000 DB9000 DB9000 DB9000 DB9000 DB9000 DB9000 DB9000 DB9000 B17900 B17900 
DB9000 DB9000 DB9000 DB9000 DB9000 DB9000 DB9000 DB9000 DB9000 B02900 B02900 B02900 B02900 DB9000 DB9000 DB9000 DB9000 DB9000 DB9000 DB9000 DB9000 DB9000 DB9000 DB9000 DB9000 DB9000 DB9000 DB9000 DB9000 DB9000 DB9000 DB6000 B26E00 B26E00 B26E00 B26E00 B26E00 B26E00 B26E00 B26E00 B26E00 B26E00 B26E00 B26E00 B26E00 DB6E00 DB9E00 DB9000 DB9000 DB9000 B02900 B02900 B02900 B02900 B02900 B02900 DB9000 DB9000 DB9000 DB9000 DB9000 DB9000 DB9000 DB9000 DB9000 DB9000 DB9000 B02900 B02900 B02900 B02900 B02900 B02900 DB9000 DB9000 DB9000 DB9000 DB9000 DB9000 DB9000 DB9000 B17900 B17900 B17900 B17900 
DB9000 DB9000 DB9000 DB9000 DB9000 DB9000 DB9000 DB9000 B02900 B02900 B02900 B02900 B02900 DB9000 DB9000 DB9000 DB9000 DB9000 DB9000 DB9000 DB9000 DB9000 DB9000 DB9000 DB9000 DB9000 DB9000 DB9000 DB9000 DB9000 DB9000 DB6000 B26E00 B26E00 B26E00 B26E00 B26E00 B26E00 B26E00 B26E00 B26E00 B26E00 B26E00 B26E00 B26E00 DB6E00 DB9E00 DB9000 DB9000 DB9000 DB9900 DB9900 B15600 DB9000 DB9000 DB9000 DB9000 DB9000 DB9000 DB9000 DB9000 DB9000 DB9000 DB9000 DB9000 DB9000 DB9000 DB9000 DB9000 B15600 DB9000 DB9000 DB9000 DB9000 DB9000 DB9000 DB9000 DB9000 DB9000 DB9000 DB9000 DB9000 DB9000 DB9000 DB9000 
DB9000 DB9000 DB9000 DB9000 DB9000 DB9000 DB9000 DB9000 DB9000 B02900 B15600 B02900 B02900 DB9000 DB9000 DB9000 DB9000 B17900 B17900 B17900 B17900 B17900 DB9000 DB9000 DB9000 DB9000 DB9000 DB9000 DB9000 DB9000 DB9000 DB6000 B26E00 B26E00 B26E00 B26E00 B26E00 B26E00 B26E00 B26E00 B26E00 B26E00 B26E00 B26E00 B26E00 DB6E00 DB9E00 DB9000 DB9000 DB9000 DB9900 DB9900 B15600 DB9000 DB9000 DB9000 DB9000 DB9000 DB9000 DB9000 DB9000 DB9000 DB9000 DB9000 DB9000 DB9000 DB9000 DB9000 DB9000 B15600 DB9000 DB9000 DB9000 DB9000 DB9000 DB9000 DB9000 DB9000 DB9000 DB9000 DB9000 DB9000 DB9000 DB9000 DB9000 
DB9000 DB9000 DB9000 DB9000 DB9000 DB9000 DB9000 DB9000 DB9000 DB9000 B15600 DB9000 DB9000 DB9000 DB9000 DB9000 DB9000 B17900 B17900 B17900 B17900 B17900 B17900 B17900 B17900 DB9000 DB9000 DB9000 DB9000 DB9000 DB9000 DB6000 B26E00 B26E00 B26E00 B26E00 B26E00 B26E00 B26E00 B26E00 B26E00 B26E00 B26E00 B26E00 B26E00 DB6E00 DB9E00 DB9000 DB9000 DB9000 DB9900 DB9900 B15600 DB9000 DB9000 DB9000 DB9000 DB9000 DB9000 DB9000 DB9000 DB9000 DB9000 DB9000 DB9000 DB9000 DB9000 DB9000 DB9000 B15600 DB9000 DB9000 DB9000 DB9000 DB9000 DB9000 DB9000 DB9000 DB9000 DB9000 DB9000 DB9000 DB9000 DB9000 DB9000 
DB2000 DB2000 DB2000 DB2000 DB2000 DB2000 DB2000 DB2000 DB2000 DB2000 B15600 DB2000 DB2000 DB2000 DB2000 DB2000 DB2000 DB2000 DB2000 DB2000 DB2000 DB2000 DB2000 DB2000 DB2000 DB2000 DB2000 DB2000 DB2000 DB2000 DB2000 DB2000 DB2000 DB2000 DB2000 DB2000 DB2000 DB2000 DB2000 DB2000 DB2000 DB2000 DB2000 DB2000 DB2000 DB2000 DB2200 DB2200 DB2200 DB2200 DB2200 DB2200 B15600 DB2000 DB2000 DB2000 DB2000 DB2000 DB2000 DB2000 DB2000 DB2000 DB2000 DB2000 DB2000 DB2000 DB2000 DB2000 DB2000 B15600 DB2000 DB2000 DB2000 DB2000 DB2000 DB2000 DB2000 DB2000 DB2000 DB2000 DBA200 DBA200 DB2000 DB2000 DB2000 
DB2000 DB2000 DB2000 DB2000 DB2000 DB2000 DB2000 DB2000 DB2000 DB2000 B15600 DB2000 DB2000 DB2000 DB2000 DB2000 DB2000 DB2000 DB2000 DB2000 DB2000 DB2000 DB2000 DB2000 DB2000 DB2000 DB2000 DB2000 DB2000 DB2000 DB2000 DB2000 DB2000 DB2000 DB2000 DB2000 DB2000 DB2000 DB2000 DB2000 DB2000 DB2000 DB2000 DB2000 DB2000 DB2000 DB2000 DB2000 DB2000 DB2000 DB2000 DB2000 DB2000 DB2000 DB2000 DB2000 DB2000 DB2000 DB2000 DB2000 DB2000 DB2000 DB2000 DB2000 DB2000 DB2000 DB2000 DB2000 DB2000 DB2000 DB2000 DB2000 DB2000 DB2000 DB2000 DB2000 DB2000 DB2000 DB2000 DBA200 DBA200 DBA200 DB2000 DB2000 DB2000 
DB2000 DB2000 DB2000 DB2000 DB2000 DB2000 DB2000 DB2000 DB2000 DB2000 B15600 DB2000 DB2000 DB2000 DB2000 DB2000 DB2000 DB2000 DB2000 DB2000 DB2000 DB2000 DB2000 DB2000 DBA200 DBA200 DBA200 DB2000 DB2000 DB2000 DB2000 DB2000 DB2000 DB2000 DB2000 DB2000 DB2000 DB2000 DB2000 DB2000 DB2000 DB2000 DB2000 DB2000 DB2000 DB2000 DB2000 DB2000 DB2000 DB2000 DB2000 DB2000 DB2000 DB2000 DB2000 DB2000 DB2000 DB2000 DB2000 DB2000 DB2000 DB2000 DB2000 DB2000 DB2000 DB2000 DB2000 DB2000 DB2000 DB2000 DB2000 DB2000 DB2000 DB2000 DB2000 DB2000 DB2000 DB2000 DBA200 DBA200 DBA200 DBA200 DB2000 DB2000 DB2000 
DB2000 DB2000 DB2000 DB2000 DB2000 DB2000 DB2000 DB2000 DB2000 DB2000 DB2000 DB2000 DB2000 DB2000 DB2000 DB2000 DB2000 DB2000 DB2000 DB2000 DB2000 DB2000 DB2000 DB2000 DBA200 DBA200 DBA200 DBA200 DB2000 DB2000 DB2000 DB2000 DB2000 DB2000 DB2000 DB2000 DB2000 DB2000 DB2000 DB2000 DB2000 DB2000 DB2000 DB2000 DB2000 DB2000 DB2000 DB2000 DB2000 DB2000 DB2000 DB2000 DB2000 DB2000 DB2000 DB2000 DB2000 DB2000 DB2000 DB2000 DB2000 DB2000 DB2000 DB2000 DB2000 DB2000 DB2000 DB2000 DB2000 DB2000 DB2000 DB2000 DB2000 DB2000 DB2000 DB2000 DB2000 DB2000 DBA200 DBA200 DBA200 DBA200 DBA200 DB2000 DB2000 
DB2000 DB2000 DB2000 DB2000 DB2000 DB2000 DB2000 DB2000 DB2000 DB2000 DB2000 DB2000 DB2000 DB2000 DB2000 DB2000 DB2000 DB2000 DB2000 DB2000 DB2000 DB2000 DB2000 DB2000 DBA200 DBA200 DBA200 DB2000 DB2000 DB2000 DB2000 DB2000 DB2000 DB2000 DB2000 DB2000 DB2000 DB2000 DB2000 DB2000 DB2000 DB2000 DB2000 DB2000 DB2000 DB2000 DB2000 DB2000 DB2000 DB2000 DB2000 DB2000 DB2000 DB2000 DB2000 DB2000 DB2000 DB2000 DB2000 DB2000 DB2000 DB2000 DB2000 DB2000 DB2000 DB2000 DB2000 DB2000 DB2000 DB2000 DB2000 DB2000 DB2000 DB2000 DB2000 DB2000 DB2000 DB2000 DB2000 DBA200 DBA200 DBA200 DBA200 DB2000 DB2000 
DB2000 DB2000 DB2000 DB2000 DB2000 DB2000 DB2000 DB2000 DB2000 DB2000 DB2000 DB2000 DB2000 DB2000 DB2000 DB2000 DB2000 DB2000 DB2000 DB2000 DB2000 DB2000 DB2000 DB2000 DBA200 DBA200 DBA200 DBA200 DB2000 DB2000 DB2000 DB2000 DB2000 DB2000 DB2000 DB2000 DB2000 DB2000 DB2000 DB2000 DB2000 DB2000 DB2000 DB2000 DB2000 DB2000 DBA200 DB2000 DB2000 DB2000 DB2000 DB2000 DB2000 DB2000 DB2000 DB2000 DB2000 DB2000 DB2000 DB2000 DB2000 DB2000 DB2000 DB2000 DB2000 DB2000 DB2000 DB2000 DB2000 DB2000 DB2000 DB2000 DB2000 DB2000 DB2000 DB2000 DB2000 DB2000 DB2000 DB2000 DBA200 DB2000 DB2000 DB2000 DB2000 
DB2000 DB2000 DB2000 DB2000 DB2000 DB2200 DBA200 DBA200 DB2000 DB2000 DB2000 DB2000 DB2000 DB2000 DB2000 DB2000 DB2000 DB2000 DB2000 DB2000 DB2000 DB2000 DB2000 DB2000 DB2000 DBA200 DBA200 DBA200 DB2000 DB2000 DB2000 DB2000 DB2000 DB2000 DB2000 DB2000 DB2000 DB2000 DB2000 DB2000 DB2000 DB2000 DB2000 DB2000 DB2000 DBA200 DBA200 DBA200 DB2000 DB2000 DB2000 DB2000 DB2000 DB2000 DB2000 DB2000 DB2000 DB2000 DB2000 DB2000 DB2000 DBA200 DBA200 DB2000 DB2000 DB2000 DB2000 DB2000 DB2000 DB2000 DB2000 DB2000 DB2000 DB2000 DB2000 DB2000 DB2000 DB2000 DB2000 DB2000 B15600 DB2000 DB2000 DB2000 DB2000 
DB2000 DB2000 DB2000 DB2000 DB2000 DB2200 DBA200 DBA200 DBA200 DB2000 DB2000 DB2000 DB2000 DB2000 DB2000 DB2000 DB2000 DB2000 DB2000 DB2000 DB2000 DB2000 DB2000 DB2000 DB2000 B15600 DB2000 DB2000 DB2000 DB2000 DB2000 DB2000 DB2000 DB2000 DB2000 DB2000 DB2000 DB2000 DB2000 DB2000 DB2000 DB2000 DB2000 DB2000 DB2000 DBA200 DBA200 DBA200 DBA200 DB2000 DB2000 DB2000 DB2000 DB2000 DB2000 DB2000 DB2000 DB2000 DB2000 DB2000 DBA200 DBA200 DBA200 DBA200 DB2000 DB2000 DB2000 DB2000 DB2000 DB2000 DB2000 DB2000 DB2000 DB2000 DB2000 DB2000 DB2000 DB2000 DB2000 DB2000 B15600 DB2000 DB2000 DB2000 DB2000 
DB2000 DB2000 DB2000 DB2000 DB2000 DBA200 DBA200 DBA200 DBA200 DB2000 DB2000 DB2000 DB2000 DB2000 DB2000 DB2000 DB2000 DB2000 DB2000 DB2000 DB2000 DB2000 DB2000 DB2000 DB2000 B15600 DB2000 DB2000 DB2000 DB2000 DB2000 DB2000 DB2000 DB2000 DB2000 DB2000 DB2000 DB2000 DB2000 DB2000 DB2000 DB2000 DB2000 DB2000 DBA200 DBA200 DBA200 DBA200 DBA200 DB2000 DB2000 DB2000 DB2000 DB2000 DB2000 DB2000 DB2000 DB2000 DB2000 DB2000 DB2000 DBA200 DBA200 DBA200 DB2000 DB2000 DB2000 DB2000 DB2000 DB2000 DB2000 DB2000 DB2000 DB2000 DB2000 DB2000 DB2000 DB2000 DB2000 DB2000 B15600 DB2000 DB2000 DB2000 DB2000 
DB2000 DB2000 DB2000 DB2000 DBA200 DBA200 DBA200 DBA200 DBA200 DB2000 DB2000 DB2000 DB2000 DB2000 DB2000 DB2000 DB2000 DB2000 DB2000 DB2000 DB2000 DB2000 DB2000 DB2000 DB2000 DB2000 DB2000 DB2000 DB2000 DB2000 DB2000 DB2000 DB2000 DB2000 DB2000 DB2000 DB2000 DB2000 DB2000 DB2000 DB2000 DB2000 DB2000 DB2000 DBA200 DBA200 DBA200 DBA200 DBA200 DBA200 DB2000 DB2000 DB2000 DB2000 DB2000 DB2000 DB2000 DB2000 DB2000 DB2000 DBA200 DBA200 DBA200 DBA200 DBA200 DB2000 DB2000 DB2000 DB2000 DB2000 DB2000 DB2000 DB2000 DB2000 DB2000 DB2000 DB2000 DB2000 DB2000 DB2000 DB2000 DB2000 DB2000 DB2000 DB2000 
DB2000 DB2000 DB2000 DB2000 DBA200 DBA200 DBA200 DBA200 DBA200 DB2000 DB2000 DB2000 DB2000 DB2000 DB2000 DB2000 DB2000 DB2000 DB2000 DB2000 DB2000 DB2000 DB2000 DB2000 DB2000 DB2000 DB2000 DB2000 DB2000 DB2000 DB2000 DB2000 DB2000 DB2000 DB2000 DB2000 DB2000 DB2000 DB2000 DB2000 DB2000 DB2000 DB2000 DB2000 DB2000 DBA200 DBA200 DBA200 DB2000 DB2000 DB2000 DB2000 DB2000 DB2000 DB2000 DB2000 DB2000 DB2000 DB2000 DB2000 DB2000 DBA200 DBA200 DBA200 DBA200 DB2000 DB2000 DB2000 DB2000 DB2000 DB2000 DB2000 DB2000 DB2000 DB2000 DB2000 DB2000 DB2000 DB2000 DB2000 DB2000 DB2000 DB2000 DB2000 DB2000 
DB2000 DB2000 DB2000 DB2000 DB2000 DB2000 DBA200 DB2000 DB2000 DB2000 DB2000 DB2000 DB2000 DB2000 DB2000 DB2000 DB2000 DB2000 DB2000 DB2000 DB2000 DB2000 DB2000 DB2000 DB2000 DB2000 DB2000 DB2000 DB2000 DB2000 DB2000 DB2000 DB2000 DB2000 DB2000 DB2000 DB2000 DB2000 DB2000 DB2000 DB2000 DB2000 DB2000 DB2000 DB2000 DB2000 B15600 DB2000 DB2000 DB2000 DB2000 DB2000 DB2000 DB2000 DB2000 DB2000 DB2000 DB2000 DB2000 DB2000 DB2000 DB2000 B15600 DB2000 DB2000 DB2000 DB2000 DB2000 DB2000 DB2000 DB2000 DB2000 DB2000 DB2000 DB2000 DB2000 DB2000 DB2000 DB2000 DB2000 DB2000 DB2000 DB2000 DB2000 DB2000 
DB2000 DB2000 DB2000 DB2000 DB2000 DB2000 B15600 DB2000 DB2000 DB2000 DB2000 DB2000 DB2000 DB2000 DB2000 DB2000 DB2000 DB2000 DB2000 DB2000 DB2000 DB2000 DB2000 DB2000 DB2000 DB2000 DB2000 DB2000 DB2000 DB2000 DB2000 DB2000 DB2000 DB2000 DB2000 DB2000 DB2000 DB2000 DB2000 DB2000 DB2000 DB2000 DB2000 DB2000 DB2000 DB2000 B15600 DB2000 DB2000 DB2000 DB2000 DB2000 DB2000 DB2000 DB2000 DB2000 DB2000 DB2000 DB2000 DB2000 DB2000 DB2000 B15600 DB2000 DB2000 DB2000 DB2000 DB2000 DB2000 DB2000 DB2000 DB2000 DB2000 DB2000 DB2000 DB2000 DB2000 DB2000 DB2000 DB2000 DB2000 DB2000 DB2000 DB2000 DB2000 
DB2000 DB2000 DB2000 DB2000 DB2000 DB2000 B15600 DB2000 DB2000 DB2000 DB2000 DB2000 DB2000 DB2000 DB2000 DB2000 DB2000 DB2000 DB2000 DB2000 DB2000 DB2000 DB2000 DB2000 DB2000 DB2000 DB2000 DB2000 DB2000 DB2000 DB2000 DB2000 DB2000 DB2000 DB2000 DB2000 DB2000 DB2000 DB2000 DB2000 DB2000 DB2000 DB2000 DB2000 DB2000 DB2000 B15600 DB2000 DB2000 DB2000 DB2000 DB2000 DB2000 DB2000 DB2000 DB2000 DB2000 DB2000 DB2000 DB2000 DB2000 DB2000 B15600 DB2000 DB2000 DB2000 DB2000 DB2000 DB2000 DB2000 DB2000 DB2000 DB2000 DB2000 DB2000 DB2000 DB2000 DB2000 DB2000 DB2000 DB2000 DB2000 DB2000 DB2000 DB2000 
DB2000 DB2000 DB2000 DB2000 DB2000 DB2000 DB2000 DB2000 DB2000 DB2000 DB2000 DB2000 DB2000 DB2000 DB2000 DB2000 DB2000 DB2000 DB2000 DB2000 DB2000 DB2000 DB2000 DB2000 DB2000 DB2000 DB2000 DB2000 DB2000 DB2000 DB2000 DB2000 DB2000 DB2000 DB2000 DB2000 DB2000 DB2000 DB2000 DB2000 DB2000 DB2000 DB2000 DB2000 DB2000 DB2000 B15600 DB2000 DB2000 DB2000 DB2000 DB2000 DB2000 DB2000 DB2000 DB2000 DB2000 DB2000 DB2000 DB2000 DB2000 DB2000 B15600 DB2000 DB2000 DB2000 DB2000 DB2000 DB2000 DB2000 DB2000 DB2000 DB2000 DB2000 DB2000 DB2000 DB2000 DB2000 DB2000 DB2000 DB2000 DB2000 DB2000 DB2000 DB2000 
DB2000 DB2000 DB2000 DB2000 DB2000 DB2000 DB2000 DB2000 DB2000 DB2000 DB2000 DB2000 DB2000 DB2000 DB2000 DB2000 DB2000 DB2000 DB2000 DB2000 DB2000 DB2000 DB2000 DB2000 DB2000 DB2000 DB2000 DB2000 DB2000 DB2000 DB2000 DB2000 DB2000 DB2000 DB2000 DB2000 DB2000 DB2000 DB2000 DB2000 DB2000 DB2000 DB2000 DB2000 DB2000 DB2000 DB2000 DB2000 DB2000 DB2000 DB2000 DB2000 DB2000 DB2000 DB2000 DB2000 DB2000 DB2000 DB2000 DB2000 DB2000 DB2000 DB2000 DB2000 DB2000 DB2000 DB2000 DB2000 DB2000 DB2000 DB2000 DB2000 DB2000 DB2000 DB2000 DB2000 DB2000 DB2000 DB2000 DB2000 DB2000 DB2000 DB2000 DB2000 DB2000 
DB2000 DB2000 DB2000 DB2000 DB2000 DB2000 DB2000 DB2000 DB2000 DB2000 DB2000 DB2000 DB2000 DB2000 DB2000 DB2000 DB2000 DB2000 DB2000 DB2000 DB2000 DB2000 DB2000 DB2000 DB2000 DB2000 DB2000 DB2000 DB2000 DB2000 DB2000 DB2000 DB2000 DB2000 DB2000 DB2000 DB2000 DB2000 DB2000 DB2000 DB2000 DB2000 DB2000 DB2000 DB2000 DB2000 DB2000 DB2000 DB2000 DB2000 DB2000 DB2000 DB2000 DB2000 DB2000 DB2000 DB2000 DB2000 DB2000 DB2000 DB2000 DB2000 DB2000 DB2000 DB2000 DB2000 DB2000 DB2000 DB2000 DB2000 DB2000 DB2000 DB2000 DB2000 DB2000 DB2000 DB2000 DB2000 DB2000 DB2000 DB2000 DB2000 DB2000 DB2000 DB2000 
DB2000 DB2000 DB2000 DB2000 DB2000 DB2000 DB2000 DB2000 DB2000 DB2000 DB2000 DB2000 DB2000 DB2000 DB2000 DB2000 DB2000 DB2000 DB2000 DB2000 DB2000 DB2000 DB2000 DB2000 DB2000 DB2000 DB2000 DB2000 DB2000 DB2000 DB2000 DB2000 DB2000 DB2000 DB2000 DB2000 DB2000 DB2000 DB2000 DB2000 DB2000 DB2000 DB2000 DB2000 DB2000 DB2000 DB2000 DB2000 DB2000 DB2000 DB2000 DB2000 DB2000 DB2000 DB2000 DB2000 DB2000 DB2000 DB2000 DB2000 DB2000 DB2000 DB2000 DB2000 DB2000 DB2000 DB2000 DB2000 DB2000 DB2000 DB2000 DB2000 DB2000 DB2000 DB2000 DB2000 DB2000 DB2000 DB2000 DB2000 DB2000 DB2000 DB2000 DB2000 DB2000 
